******************************************
*                *        *      * * *   *
* ************** * ************* * * *   *
*         *                        *   ***
******** **** ******************** *** * *
*          *         *          *        *
*          ** * * * ** *****    *   ******
*          *                        *    *
* *********** ************ ********** ****
* *       * * *     *                 *  *
* * ******* * *     *  ****    *    *** **
* *           * *** ******** *************
*             *               *       *  *
* *********** ** ***************** ****  *
*                                        *
****   ******** * *         ****  ** *****
*  *          * ****** *********  ** *****
* ***********           **              **
*             *************** ************
** * * * **********                    ***
******************************************