*************************************************
*                  *               * *          *
*                  *               * *          *
*              T   *               * *          *
************* **************       ************ *
*                                               *
************************   **********************
*    K   *                    * * * *           *
*        ***************      * * * *        ****
*                                             T *
****************** *********************  *******
*                                               *
************* **************       ************ *
*                 *                             *
*************************************************