******************************************
*                                        *
*                                        *
*                                        *
*                                        *
*                                        *
*                                        *
*                                        *
*                                        *
*                                        *
*                                        *
*                                        *
*                                        *
*                                        *
*                                        *
*                                        *
*                                        *
*                                        *
*                                        *
*                                        *
*                                        *
*                                        *
******************************************